1111111111111
1000000000001
1000001111001
1000101100001
1111111111111