1111111111111
100P00C0000E1
1000011110011
10C0101111111
1111111111111