1111111111111
10P000C000001
1000001111001
10C0101100001
1111110111111