1111111111111
100P0000000E1
1111111111111
1000011110011
1000000001111
1111111111111