1111111
1000001
1EP0C01
1000001
1111111
